Level 1

  ##############
  #   #        #
  # $ $ $ $ #$ #
  # #$# ###  $ #
  # # .....##$##
  #  ...+..  $ #
####$# ....# # #
#    #### # $$ #
# $#    $$ $ # #
# $ ..#        #
################

Solution
rrrrdDuullllllllDDlllddRRRllUluRddrrUUdrrrdrrrrrrruuuuLLLLLdlUllllluuuurrdDDrruuurrdLulDDDlddrruLulluuRRdddrrrrrrrddddlllllUUUUdddrdrrUUUdddrruuuulLLLLdlluuuuurrrrrrrddLDuruullllllldddddrrddrdrrrruuuuLLLrddddlluluurUldlllUruuullddRluurrdDDldRRRlluuuuurrdLulDDDDldRRluuuurrurrrrrddlddllllDlluuuullullddddrRurrddlUruLdlUrrddrrurrrddddlllllullluUddrrrdrrrrruuuullldlluuuullullddddRRurrddlUlldddrrrdrrruRuruulllLdlUUUddlllluuuurrdrRurrrrrrDDDuuullllllddddrrrrrddlddrrruuuuLLLLLLrrrrruuuulllllldddDldRuuuuurrrrddRluullllddddrrrrrruUddlllllllllddLrdrrrdrruUUddrruruullLLLuuullDDuurrurrdLulDDDDuuullulldRRRRurrdLulDDDuurrurrdLLLulDDulllldddrdddrrrRdrUUdrruruuruuruulDDDullulllllllldddrdddrrrrrrrdrrruuuuLLLLLrrrddldllllllldlluluRRlddrrurrrrrrruruuruullulllllllldddrdDDrrrrrrrdrUUUdddrruuuulLLLrrrrddLrddlluUUdrruulLL

Solver: Festival 3.1
Solver time: 00:00:00
Solver date: 2024-06-16  02:48:35


Level 2

  ##############
  #   #        #
  # $ $ $ $ #$ #
  # # . ###  $ #
  # # .....##$##
  # *.*+#**  $ #
####.# ....# # #
#    #### # $$ #
# $#    $$ $ $ #
#   ..#        #
################

Solver: Festival 3.1
Solver time: 00:00:07
Solver date: 2024-06-16  02:48:42


Level 3

   ########   
   #      #   
   # $$#  ####
#### #  $    #
#   $#..##$$ #
#  # .+..  # #
# #  .... #  #
# $$##..#$   #
#    $  # ####
####  # $ #   
   #   #$ #   
   #      #   
   ########   

Solution
rrrdDDDuurrruuuullluulllDDDDDuuuuurrrddLLruulldDDrddlluRdrUrrrUdlddrrruuuulLLLLruulldDDDldRRulllUlllddddrrrdrdrdrrrUUUUUdrrruuuullddLLLrrruulllldDrddddRluuuulllulllddddrrrdrdrdrrruUUUUdrrruuuullddLLLLuuuulldRurDDDurrrrddlddddddlllululuRRlddrdrrruullUUUddlllllluuururrddlDuruulllddddrRRRRlddrdrrruullUUddrruuuuruullllullDDDulllddddrruuRuuuurrdrrrrrrdLrddldlluurUruLLLLruulldDullddllldddRluururrddlDldRRRRlddrdrrruullUdrrddlUdlluluurrdRdrUUUUdrrruuulldL

Solver: Festival 3.1
Solver time: 00:00:01
Solver date: 2024-06-16  02:48:43